1111111111111111
1000000111001111
1010010111001111
1011110100000011
1011110100000011
1010010111001111
1000000111001111
1111111111111111
1111111111111111
1100001100000001
1010010100000001
1001100100000011
1001100100000111
1010010100000011
1100001100000001
1111111111111111