111111111111111111111
100000000000000000001
10P000C000C000C000E01
100000000000000000001
111111111111111111111