11111111111111111
10001100000110001
10P00000000000C01
10001100000110001
11111110001111111
11111110001111111
11111100000111111
11111100000111111
11111100E00111111
11111100000111111
11111100000111111
11111111111111111