111111111111111111111111111111111111111
100000000000000000000000000000000000111
100P00000000000000000000000000000000111
100000000000000000000000000000000000111
100000000000000000000000000000000000111
111111111111111111111111111111100000111
111111111111111111111111111111100000111
111111111111111111111111111111100000111
100000000000000000000000000000000000111
100C00000000000000000000000000000000111
100000000000000000000000000C00000000111
100000000000000000000000000000000000111
100000111111111111111111100000111111111
100000111111111111111111100000111111111
100000111111111111111111100000111111111
100000111111111111111111100000111111111
100000000000000000000000000000000000001
100000000000000000000000000000000000001
100000000000000000000000C00000000000001
100000000000000000000000000000000000001
111000000000000001110000000000000000001
111000000000000001110000000000000000001
11100000000000000111000000000000E000001
111000000000000001110000000000000000001
111000000000000001110000000000000000001
111000000000000001110000000000000000001
111111111111111111111111111111111111111