11111111111111111
10001111000000111
10P00000000000111
10001111000000111
11111111000000111
111111110C00C0111
11111111000000111
11000111110011111
110C0111110011111
11101111110000001
11100000000000E01
11111011110000001
11110C01111111111
11110001111111111
11111111111111111