111111111111111111111
100000000000000000001
10P000C000C000C000001
100000000000000000001
111111111111111111111