111111111111111111111
10000000000C000000001
10P000C000CC00C000E01
10000000000C000000001
111111111111111111111