111111111111111111111
100000000100000000001
10P000C001C000C000E01
100000000100000000001
111111111111111111111